1111111111111111
1CCCCCCCCCCCCCC1
1CCCCCCCCCCCCCC1
1000000000000001
1000000000000001
100000000P000001
10000000000000E1
1000000000011111
1100000000010001
1C00000000010001
1111111111111111