1111111111111111111111111111111111111111111
1C1CCCCCCCCCCCCCCCCCCCCCCCCCCCCCCCCCCCCCCC1
1C1CCCCCCCCCCCCCCCCCCCCCCCCCCCCCCCCCCCCCCC1
1P10000000000000000000000000000000000000001
1010000000000000000000000000000000000000001
1000000000000000000010000000000000000000011
10000000000000000000E1000000000000000000001
1000000000000000000111000000000000000000001
10000000000000000000C1000000000000000000001
1111111111111111111111111111111111111111111